arouse: вызывать, пробуждать 
pretty: довольно-таки 
grand: большой, великий 
volume: громкость 
draw: тянуть 
coach: автобус, вагон, телега 
provide: обеспечивать, снабжать 
provider: поставщик 
provision: обеспечение 
cope with: совладать,  справиться
condition: состояние 
land: приземляться, высаживаться 
scope: пределы,  район 
pack: пачка, связка, колода, и т. д. 
package: пакет 
craft: ремесло, мастерство 
craftsman: ремесленник, 
crafty: ловкий, хитрый, 
worth: стоимость, стоящий 
worthy: достойный 
urban: городской
urbanization: урбанизация 
pond: пруд 
familiar: знакомый 
familiarity: знакомство 
unfamiliar: незнакомый 
familiarize: ознакомиться
tap: стучать
column: столб,колонна
guilt: вина 
guilty: виновный
arm: рука
forearm: предплечье, 
chamber: кабинет, зал, палата, камера
owe: задолжать
include: включать, содержать в себе 
inclusion: включение 
inclusive: включающий в себя 
inclusively: включительно 
appoint: назначать, утверждать
appointment: деловое свидание, встреча 
appointment: назначение на должность 
celebrate: праздновать 
celebration: праздник 
celebratory: праздничный 
abuse: оскорблять, бранить, брань 
abusive: оскорбительный
get up: встать, подняться, просыпаться
